20
21
4 4 4 4 4 4 4 4 4 4 4 4 4 4 4 4 4 4 4 4 
4 3 0 0 0 0 0 0 0 0 0 0 0 0 0 0 0 0 0 4 
4 0 0 0 0 0 0 0 0 0 1 0 0 0 0 0 0 0 0 4 
4 0 0 0 5 0 0 0 0 1 1 0 0 0 0 0 0 0 0 4 
4 0 0 0 0 0 0 0 0 1 3 1 0 0 0 0 0 0 0 4 
4 0 0 0 0 0 0 0 1 0 0 1 0 0 0 0 0 0 0 4 
4 0 0 0 0 0 0 0 1 0 0 0 1 0 0 0 0 0 6 4 
4 0 0 0 0 0 0 1 0 0 0 0 1 0 0 0 0 0 0 4 
4 0 0 0 0 0 0 1 0 0 0 0 0 1 0 0 0 0 0 4 
4 0 0 0 0 0 0 0 1 0 0 1 0 0 0 0 0 0 0 4 
4 0 0 0 0 0 0 0 0 0 3 0 0 0 0 0 0 0 0 4 
4 0 0 0 0 0 0 0 1 0 0 1 0 0 0 0 0 0 0 4 
4 0 0 0 0 0 0 1 0 0 0 0 0 1 0 0 0 0 0 4 
4 0 0 0 0 0 0 1 0 0 0 0 1 0 0 0 0 0 0 4 
4 0 0 0 0 0 0 0 1 0 0 0 1 0 0 0 0 0 6 4 
4 0 0 0 0 0 0 0 1 0 0 1 0 0 0 0 0 0 0 4 
4 0 0 0 0 0 0 0 0 1 3 1 0 0 0 0 0 0 0 4 
4 0 0 0 5 0 0 0 0 1 1 0 0 0 0 0 0 0 0 4 
4 0 0 0 0 0 0 0 0 0 1 0 0 0 0 0 0 0 0 4 
4 3 0 0 0 0 0 0 0 0 0 0 0 0 0 0 0 0 0 4 
4 4 4 4 4 4 4 4 4 4 4 4 4 4 4 4 4 4 4 4 
400
4 3
4 17
18 14
18 6
